%%..%....@........
.................
.................
.................
.................
....#............
.................
.................
.............%%%%
.................
...####.....##...
.................
...........&.....
...........&.....
.........&&&.....
%................
%...............%