.....w..@..w.....
.....w..@..w.....
...w.p..@..p.w...
...w.p..@..p.w...
...p.p.....p.p...
...p.pbbbbbp.p...
w..p.p.....p.p..w
w..pbbbp.pbbbp..w
w..p...p.p...p..w
...bbbbp.pbbbb...
....w..p.p..w....
....pbbb.bbbp....
....p.......p....
.p..p.......p..p.
.p.bbbw...wbbb.p.
.................
.................