........@........
............p....
...bbbbbbb..p....
......pbbbbbp....
......p.....p....
......p.....p....
......p.....p....
.................
..p.bbbbbb.......
..p..............
..p..............
..p..............
.bbb.p...........
.....p...........
.....p...........
.ww..............
.w...bbbbb..www..