........@........
...........p.....
...........p.....
..bbbbbbbb.p.....
...........p.....
......p..........
.p....p..........
.p....p..bbbbbbb.
.p.............p.
.p.bbbbbbb.....p.
.p.............p.
...............p.
.................
.................
.................
.................
.................