pp..p....@.......
.................
.................
.................
.................
....b............
.................
.................
.............pppp
.................
...bbbb.....bb...
.................
...........w.....
...........w.....
.........www.....
p................
p...............p