........@........
.................
.................
.wbbbbbbb..p.....
.w....bbbbbp.....
.w.bbbbbb..p.....
...........p.bbb.
...........p.....
.......p.........
...bbbbp.........
....p..p.........
....p.bbbbbb.p...
....p........p...
.............p...
.ww.bbbbbbb..p...
.............p...
............www..