........@..www...
........@........
........@...p....
....wbbbbb..p....
.....p......p..ww
.....p.bbbbbbb.ww
...p.p.........ww
...p.bbbb.w...p..
...p..........p..
...p..........p..
...wpbbbbbbbb.p..
...wp............
....p......bbbbb.
....p....p.......
..bbbbbb.p.......
...........w.....
.........www.....